NO textures/redbrick.xpm
SO textures/greystone.xpm

WE     textures/eagle.xpm
EA         textures/wood.xpm

F 105,105,105
C 176,196,222


11111111111111111111111111111111111
10000000100000000000000000000000001
1000000000010000000000000000000001
10000000000001000000000000000000001
10000000000000000000000000000000001
10000000000010000000000000000000001
11111110011111111101111111111111111
11111100001111111101111111111111111
100000000000001W0000000000000000001
10000000000010010000000000000000001
10000000000001000000000000000000001
10000000000000000000000000000000001
10000000000010000000000000000000001
11111111111111111111111111111111111